1111111111111
10010000000C0
1100011111001
1P0011E000001
1111111111111