1111111111111111111
10C0C0C0C0C0C0C0C01
100000C000000000001
1CCCC000000000ECC01
100C0CC00C00000PCC1
100000CCCCCCCC00CC1
10000C0C0CC0C0C0C01
1111111111111111111