1111111111111
1C10000000101
1000000001P11
1000001000001
1000010000001
1000010000001
1000010000001
1000010000001
1000010000001
1000010000001
1000010000001
1000010000001
1000010000001
1000010000001
1000010000001
1000010000001
1000010000001
1000010000001
1000010000001
1000010000001
1000010000001
1000010000001
1000010000001
1000010000001
1000010000001
1000010000001
1000010000001
1000010000001
1000010000001
1000010000001
1000010000001
1000010000001
1000010000001
1000010000001
1000010000001
1000010000001
1000010000001
1000010000001
1000010000001
1000010000001
1000010000001
10000100E0001
1000010000001
1000010000001
1000010000001
1000010000001
1000010000001
1000010000001
1000010000001
1000010000001
1000010000001
1111111111111