1111111111111111
11110011P0001E11
1000000000000001
1000000001000001
1111111111111111